"aa" = (/turf/t0, /area)
"ab" = (/turf/t1, /area)
"ac" = (/turf/t2, /area)
"ad" = (/turf/t3, /area)
"ae" = (/turf/t4, /area)
"af" = (/turf/t5, /area)
"ag" = (/turf/t6, /area)
"ah" = (/turf/t7, /area)
"ai" = (/turf/t8, /area)
"aj" = (/turf/t9, /area)
"ak" = (/turf/t10, /area)
"al" = (/turf/t11, /area)
"am" = (/turf/t12, /area)
"an" = (/turf/t13, /area)
"ao" = (/turf/t14, /area)
"ap" = (/turf/t15, /area)
"aq" = (/turf/t16, /area)
"ar" = (/turf/t17, /area)
"as" = (/turf/t18, /area)
"at" = (/turf/t19, /area)
"au" = (/turf/t20, /area)
"av" = (/turf/t21, /area)
"aw" = (/turf/t22, /area)
"ax" = (/turf/t23, /area)
"ay" = (/turf/t24, /area)
"az" = (/turf/t25, /area)
"ba" = (/turf/t26, /area)
"bb" = (/turf/t27, /area)
"bc" = (/turf/t28, /area)
"bd" = (/turf/t29, /area)
"be" = (/turf/t30, /area)
"bf" = (/turf/t31, /area)
"bg" = (/turf/t32, /area)
"bh" = (/turf/t33, /area)
"bi" = (/turf/t34, /area)
"bj" = (/turf/t35, /area)
"bk" = (/turf/t36, /area)
"bl" = (/turf/t37, /area)
"bm" = (/turf/t38, /area)
"bn" = (/turf/t39, /area)
"bo" = (/turf/t40, /area)
"bp" = (/turf/t41, /area)
"bq" = (/turf/t42, /area)
"br" = (/turf/t43, /area)
"bs" = (/turf/t44, /area)
"bt" = (/turf/t45, /area)
"bu" = (/turf/t46, /area)
"bv" = (/turf/t47, /area)
"bw" = (/turf/t48, /area)
"bx" = (/turf/t49, /area)
"by" = (/turf/t50, /area)
"bz" = (/turf/t51, /area)
"ca" = (/turf/t52, /area)
"cb" = (/turf/t53, /area)
"cc" = (/turf/t54, /area)
"cd" = (/turf/t55, /area)
"ce" = (/turf/t56, /area)
"cf" = (/turf/t57, /area)
"cg" = (/turf/t58, /area)
"ch" = (/turf/t59, /area)
"ci" = (/turf/t60, /area)
"cj" = (/turf/t61, /area)
"ck" = (/turf/t62, /area)
"cl" = (/turf/t63, /area)
"cm" = (/turf/t64, /area)
"cn" = (/turf/t65, /area)
"co" = (/turf/t66, /area)
"cp" = (/turf/t67, /area)
"cq" = (/turf/t68, /area)
"cr" = (/turf/t69, /area)
"cs" = (/turf/t70, /area)
"ct" = (/turf/t71, /area)
"cu" = (/turf/t72, /area)
"cv" = (/turf/t73, /area)
"cw" = (/turf/t74, /area)
"cx" = (/turf/t75, /area)
"cy" = (/turf/t76, /area)
"cz" = (/turf/t77, /area)
"da" = (/turf/t78, /area)
"db" = (/turf/t79, /area)
"dc" = (/turf/t80, /area)
"dd" = (/turf/t81, /area)
"de" = (/turf/t82, /area)
"df" = (/turf/t83, /area)
"dg" = (/turf/t84, /area)
"dh" = (/turf/t85, /area)
"di" = (/turf/t86, /area)
"dj" = (/turf/t87, /area)
"dk" = (/turf/t88, /area)
"dl" = (/turf/t89, /area)
"dm" = (/turf/t90, /area)
"dn" = (/turf/t91, /area)
"do" = (/turf/t92, /area)
"dp" = (/turf/t93, /area)
"dq" = (/turf/t94, /area)
"dr" = (/turf/t95, /area)
"ds" = (/turf/t96, /area)
"dt" = (/turf/t97, /area)
"du" = (/turf/t98, /area)
"dv" = (/turf/t99, /area)
"dw" = (/turf/t100, /area)
"dx" = (/turf/t101, /area)
"dy" = (/turf/t102, /area)
"dz" = (/turf/t103, /area)
"ea" = (/turf/t104, /area)
"eb" = (/turf/t105, /area)
"ec" = (/turf/t106, /area)
"ed" = (/turf/t107, /area)
"ee" = (/turf/t108, /area)
"ef" = (/turf/t109, /area)
"eg" = (/turf/t110, /area)
"eh" = (/turf/t111, /area)
"ei" = (/turf/t112, /area)
"ej" = (/turf/t113, /area)
"ek" = (/turf/t114, /area)
"el" = (/turf/t115, /area)
"em" = (/turf/t116, /area)
"en" = (/turf/t117, /area)
"eo" = (/turf/t118, /area)
"ep" = (/turf/t119, /area)
"eq" = (/turf/t120, /area)
"er" = (/turf/t121, /area)
"es" = (/turf/t122, /area)
"et" = (/turf/t123, /area)
"eu" = (/turf/t124, /area)
"ev" = (/turf/t125, /area)
"ew" = (/turf/t126, /area)
"ex" = (/turf/t127, /area)
"ey" = (/turf/t128, /area)
"ez" = (/turf/t129, /area)
"fa" = (/turf/t130, /area)
"fb" = (/turf/t131, /area)
"fc" = (/turf/t132, /area)
"fd" = (/turf/t133, /area)
"fe" = (/turf/t134, /area)
"ff" = (/turf/t135, /area)
"fg" = (/turf/t136, /area)
"fh" = (/turf/t137, /area)
"fi" = (/turf/t138, /area)
"fj" = (/turf/t139, /area)
"fk" = (/turf/t140, /area)
"fl" = (/turf/t141, /area)
"fm" = (/turf/t142, /area)
"fn" = (/turf/t143, /area)
"fo" = (/turf/t144, /area)
"fp" = (/turf/t145, /area)
"fq" = (/turf/t146, /area)
"fr" = (/turf/t147, /area)
"fs" = (/turf/t148, /area)
"ft" = (/turf/t149, /area)
"fu" = (/turf/t150, /area)
"fv" = (/turf/t151, /area)
"fw" = (/turf/t152, /area)
"fx" = (/turf/t153, /area)
"fy" = (/turf/t154, /area)
"fz" = (/turf/t155, /area)
"ga" = (/turf/t156, /area)
"gb" = (/turf/t157, /area)
"gc" = (/turf/t158, /area)
"gd" = (/turf/t159, /area)
"ge" = (/turf/t160, /area)
"gf" = (/turf/t161, /area)
"gg" = (/turf/t162, /area)
"gh" = (/turf/t163, /area)
"gi" = (/turf/t164, /area)
"gj" = (/turf/t165, /area)
"gk" = (/turf/t166, /area)
"gl" = (/turf/t167, /area)
"gm" = (/turf/t168, /area)
"gn" = (/turf/t169, /area)
"go" = (/turf/t170, /area)
"gp" = (/turf/t171, /area)
"gq" = (/turf/t172, /area)
"gr" = (/turf/t173, /area)
"gs" = (/turf/t174, /area)
"gt" = (/turf/t175, /area)
"gu" = (/turf/t176, /area)
"gv" = (/turf/t177, /area)
"gw" = (/turf/t178, /area)
"gx" = (/turf/t179, /area)
"gy" = (/turf/t180, /area)
"gz" = (/turf/t181, /area)
"ha" = (/turf/t182, /area)
"hb" = (/turf/t183, /area)
"hc" = (/turf/t184, /area)
"hd" = (/turf/t185, /area)
"he" = (/turf/t186, /area)
"hf" = (/turf/t187, /area)
"hg" = (/turf/t188, /area)
"hh" = (/turf/t189, /area)
"hi" = (/turf/t190, /area)
"hj" = (/turf/t191, /area)
"hk" = (/turf/t192, /area)
"hl" = (/turf/t193, /area)
"hm" = (/turf/t194, /area)
"hn" = (/turf/t195, /area)
"ho" = (/turf/t196, /area)
"hp" = (/turf/t197, /area)
"hq" = (/turf/t198, /area)
"hr" = (/turf/t199, /area)
"hs" = (/turf/t200, /area)
"ht" = (/turf/t201, /area)
"hu" = (/turf/t202, /area)
"hv" = (/turf/t203, /area)
"hw" = (/turf/t204, /area)
"hx" = (/turf/t205, /area)
"hy" = (/turf/t206, /area)
"hz" = (/turf/t207, /area)
"ia" = (/turf/t208, /area)
"ib" = (/turf/t209, /area)
"ic" = (/turf/t210, /area)
"id" = (/turf/t211, /area)
"ie" = (/turf/t212, /area)
"if" = (/turf/t213, /area)
"ig" = (/turf/t214, /area)
"ih" = (/turf/t215, /area)
"ii" = (/turf/t216, /area)
"ij" = (/turf/t217, /area)
"ik" = (/turf/t218, /area)
"il" = (/turf/t219, /area)
"im" = (/turf/t220, /area)
"in" = (/turf/t221, /area)
"io" = (/turf/t222, /area)
"ip" = (/turf/t223, /area)
"iq" = (/turf/t224, /area)
"ir" = (/turf/t225, /area)
"is" = (/turf/t226, /area)
"it" = (/turf/t227, /area)
"iu" = (/turf/t228, /area)
"iv" = (/turf/t229, /area)
"iw" = (/turf/t230, /area)
"ix" = (/turf/t231, /area)
"iy" = (/turf/t232, /area)
"iz" = (/turf/t233, /area)
"ja" = (/turf/t234, /area)
"jb" = (/turf/t235, /area)
"jc" = (/turf/t236, /area)
"jd" = (/turf/t237, /area)
"je" = (/turf/t238, /area)
"jf" = (/turf/t239, /area)
"jg" = (/turf/t240, /area)
"jh" = (/turf/t241, /area)
"ji" = (/turf/t242, /area)
"jj" = (/turf/t243, /area)
"jk" = (/turf/t244, /area)
"jl" = (/turf/t245, /area)
"jm" = (/turf/t246, /area)
"jn" = (/turf/t247, /area)
"jo" = (/turf/t248, /area)
"jp" = (/turf/t249, /area)
"jq" = (/turf/t250, /area)
"jr" = (/turf/t251, /area)
"js" = (/turf/t252, /area)
"jt" = (/turf/t253, /area)
"ju" = (/turf/t254, /area)
"jv" = (/turf/t255, /area)
"jw" = (/turf/t256, /area)
"jx" = (/turf/t257, /area)
"jy" = (/turf/t258, /area)
"jz" = (/turf/t259, /area)
"ka" = (/turf/t260, /area)
"kb" = (/turf/t261, /area)
"kc" = (/turf/t262, /area)
"kd" = (/turf/t263, /area)
"ke" = (/turf/t264, /area)
"kf" = (/turf/t265, /area)
"kg" = (/turf/t266, /area)
"kh" = (/turf/t267, /area)
"ki" = (/turf/t268, /area)
"kj" = (/turf/t269, /area)
"kk" = (/turf/t270, /area)
"kl" = (/turf/t271, /area)
"km" = (/turf/t272, /area)
"kn" = (/turf/t273, /area)
"ko" = (/turf/t274, /area)
"kp" = (/turf/t275, /area)
"kq" = (/turf/t276, /area)
"kr" = (/turf/t277, /area)
"ks" = (/turf/t278, /area)
"kt" = (/turf/t279, /area)
"ku" = (/turf/t280, /area)
"kv" = (/turf/t281, /area)
"kw" = (/turf/t282, /area)
"kx" = (/turf/t283, /area)
"ky" = (/turf/t284, /area)
"kz" = (/turf/t285, /area)
"la" = (/turf/t286, /area)
"lb" = (/turf/t287, /area)
"lc" = (/turf/t288, /area)
"ld" = (/turf/t289, /area)
"le" = (/turf/t290, /area)
"lf" = (/turf/t291, /area)
"lg" = (/turf/t292, /area)
"lh" = (/turf/t293, /area)
"li" = (/turf/t294, /area)
"lj" = (/turf/t295, /area)
"lk" = (/turf/t296, /area)
"ll" = (/turf/t297, /area)
"lm" = (/turf/t298, /area)
"ln" = (/turf/t299, /area)
"lo" = (/turf/t300, /area)
"lp" = (/turf/t301, /area)
"lq" = (/turf/t302, /area)
"lr" = (/turf/t303, /area)
"ls" = (/turf/t304, /area)
"lt" = (/turf/t305, /area)
"lu" = (/turf/t306, /area)
"lv" = (/turf/t307, /area)
"lw" = (/turf/t308, /area)
"lx" = (/turf/t309, /area)
"ly" = (/turf/t310, /area)
"lz" = (/turf/t311, /area)
"ma" = (/turf/t312, /area)
"mb" = (/turf/t313, /area)
"mc" = (/turf/t314, /area)
"md" = (/turf/t315, /area)
"me" = (/turf/t316, /area)
"mf" = (/turf/t317, /area)
"mg" = (/turf/t318, /area)
"mh" = (/turf/t319, /area)
"mi" = (/turf/t320, /area)
"mj" = (/turf/t321, /area)
"mk" = (/turf/t322, /area)
"ml" = (/turf/t323, /area)
"mm" = (/turf/t324, /area)
"mn" = (/turf/t325, /area)
"mo" = (/turf/t326, /area)
"mp" = (/turf/t327, /area)
"mq" = (/turf/t328, /area)
"mr" = (/turf/t329, /area)
"ms" = (/turf/t330, /area)
"mt" = (/turf/t331, /area)
"mu" = (/turf/t332, /area)
"mv" = (/turf/t333, /area)
"mw" = (/turf/t334, /area)
"mx" = (/turf/t335, /area)
"my" = (/turf/t336, /area)
"mz" = (/turf/t337, /area)
"na" = (/turf/t338, /area)
"nb" = (/turf/t339, /area)
"nc" = (/turf/t340, /area)
"nd" = (/turf/t341, /area)
"ne" = (/turf/t342, /area)
"nf" = (/turf/t343, /area)
"ng" = (/turf/t344, /area)
"nh" = (/turf/t345, /area)
"ni" = (/turf/t346, /area)
"nj" = (/turf/t347, /area)
"nk" = (/turf/t348, /area)
"nl" = (/turf/t349, /area)
"nm" = (/turf/t350, /area)
"nn" = (/turf/t351, /area)
"no" = (/turf/t352, /area)
"np" = (/turf/t353, /area)
"nq" = (/turf/t354, /area)
"nr" = (/turf/t355, /area)
"ns" = (/turf/t356, /area)
"nt" = (/turf/t357, /area)
"nu" = (/turf/t358, /area)
"nv" = (/turf/t359, /area)
"nw" = (/turf/t360, /area)
"nx" = (/turf/t361, /area)
"ny" = (/turf/t362, /area)
"nz" = (/turf/t363, /area)
"oa" = (/turf/t364, /area)
"ob" = (/turf/t365, /area)
"oc" = (/turf/t366, /area)
"od" = (/turf/t367, /area)
"oe" = (/turf/t368, /area)
"of" = (/turf/t369, /area)
"og" = (/turf/t370, /area)
"oh" = (/turf/t371, /area)
"oi" = (/turf/t372, /area)
"oj" = (/turf/t373, /area)
"ok" = (/turf/t374, /area)
"ol" = (/turf/t375, /area)
"om" = (/turf/t376, /area)
"on" = (/turf/t377, /area)
"oo" = (/turf/t378, /area)
"op" = (/turf/t379, /area)
"oq" = (/turf/t380, /area)
"or" = (/turf/t381, /area)
"os" = (/turf/t382, /area)
"ot" = (/turf/t383, /area)
"ou" = (/turf/t384, /area)
"ov" = (/turf/t385, /area)
"ow" = (/turf/t386, /area)
"ox" = (/turf/t387, /area)
"oy" = (/turf/t388, /area)
"oz" = (/turf/t389, /area)
"pa" = (/turf/t390, /area)
"pb" = (/turf/t391, /area)
"pc" = (/turf/t392, /area)
"pd" = (/turf/t393, /area)
"pe" = (/turf/t394, /area)
"pf" = (/turf/t395, /area)
"pg" = (/turf/t396, /area)
"ph" = (/turf/t397, /area)
"pi" = (/turf/t398, /area)
"pj" = (/turf/t399, /area)


(1,1,1) = {"
aaabacadaeafagahaiajakalamanaoapaqarasat
auavawaxayazbabbbcbdbebfbgbhbibjbkblbmbn
bobpbqbrbsbtbubvbwbxbybzcacbcccdcecfcgch
cicjckclcmcncocpcqcrcsctcucvcwcxcyczdadb
dcdddedfdgdhdidjdkdldmdndodpdqdrdsdtdudv
dwdxdydzeaebecedeeefegeheiejekelemeneoep
eqereseteuevewexeyezfafbfcfdfefffgfhfifj
fkflfmfnfofpfqfrfsftfufvfwfxfyfzgagbgcgd
gegfggghgigjgkglgmgngogpgqgrgsgtgugvgwgx
gygzhahbhchdhehfhghhhihjhkhlhmhnhohphqhr
hshthuhvhwhxhyhziaibicidieifigihiiijikil
iminioipiqirisitiuiviwixiyizjajbjcjdjejf
jgjhjijjjkjljmjnjojpjqjrjsjtjujvjwjxjyjz
kakbkckdkekfkgkhkikjkkklkmknkokpkqkrkskt
kukvkwkxkykzlalblcldlelflglhliljlklllmln
lolplqlrlsltlulvlwlxlylzmambmcmdmemfmgmh
mimjmkmlmmmnmompmqmrmsmtmumvmwmxmymznanb
ncndnenfngnhninjnknlnmnnnonpnqnrnsntnunv
nwnxnynzoaobocodoeofogohoiojokolomonooop
oqorosotouovowoxoyozpapbpcpdpepfpgphpipj"}